10,9
7,8
1,0
X0XXXXXXXX
X00X0XXXXX
XX000XXXXX
XXXX0000XX
XXXX0XXXXX
XXXX0XXXXX
XXXX0000XX
XXXXXXX0XX
XXXXXXX0XX
