21,20
20,4
0,1
XXXXXXXXXXXXXXXXXXXXX
0000000X00000000XXXXX
X0XXXX0X0XXXXXX0XXXXX
X000000X0XXX0XX0XXXXX
XXXX0XXX000X0XX000000
XX0X0XXXXX0X0XX0XXXXX
XX0X0XXXXX00000000XXX
XX0X000000XXXXX0X0XXX
XX0XXXXXX0XXXXX0X000X
XX0000XXX0XXXXX0X0XXX
XX0XX0XXX0XX0000X000X
XX0XX00000XX0XXXXXX0X
XX000XXXX0XX00000000X
XXXXXXXXX0XX0XXXX0XXX
XX00000000XX0X00X0XXX
XX0XXXXXX0X00XX0X0XXX
XX0000XXX0XX00X0X0XXX
XX0XXXX00000XXX0X0XXX
XX000000XXX0000000XXX
XXXXXXXXXXXXXXXXXXXXX
