15,21
0,10
0,1
XXXXXXXXXXXXXXX
00000000000XXXX
XXXXXXX000000XX
X0000000XXX00XX
X0XXXXXXXXXX0XX
X000000000000XX
XXXXXXXXX0XXXXX
XXXXXXXXX0XXXXX
XXXXXXXXX0XXXXX
XXXXXXXXX0XXXXX
0000000000XXXXX
XXXXXXXXXXXXXXX

